00000000000000000000000000000000000000000
00000000000000000000000000000000000000000
00000000000000000000000000000000000000000
00000000000000000000000000000000000000000
00000000000000000000000000000000000000000
78890000000000000000000000000000000000000
55555555555555WWWWWWWWWW00000000000000000
55555555555555000000000000000000000000000
22222222222222000000000000000000000000000