NEXT_PATH: maps/map1.ber
TILE_B: textures/Tiles/TileBas.xpm
TILE_H: textures/Tiles/TileHaut.xpm
TILE_HG: textures/Tiles/TitleHautGauche.xpm
TILE_HD: textures/Tiles/TileHautDroit.xpm
TILE_M: textures/Tiles/TileMilieu.xpm
DOOR: textures/Doors/Door.xpm
GROUND: textures/Backgrounds/BG_Forest_Ground.xpm
BACKGROUND: textures/Backgrounds/BG_Forest.xpm
SKY: textures/Backgrounds/BG_Forest_Sky.xpm
MAP:
0000000000000000000000000000000000000000000
0000000000000000000000000000000000000000000
0000000000000000000000000000000000000000000
0000000000000000000000000000000000000000000
0000000000000000000000000000000E00000000000
55555555555555WWWWWWWWWW5555505555555555555
55555555555555WWWWWWWWWW5555505555555555555
0000000000000000000000000000000000000000055
55555555555555WWWWWWWWWW5555505555555555555
0000000000000000000000000000000000000000055
55555555555555WWWWWWWWWW5555505555555555555
0000000000000000000000000000000000000000055
55555555555555WWWWWWWWW05555555555555555555
0000000000000000000000000000000000000000055
55555555555555WWWWWWWWWW5555555555555555555